########################################
#XXXOOOXXXXXXXXXOXXXXXXXXXXXXXXXXXXXXXX#
#XXXXXXOXXXXXXXXXO#############VVVVVVVV#
#OXXXXXXXXXXXXXXOXXXXXXXXXXXXXXVVVVVVVV#
#OXXXXXOOXXXXXXXXXXXXXXXXXXXXXXVVVVVVVV#
#XXOOXXXXXXXXXXXXOOXXXXXXXXXXXXVVVVVVVV#
#XOOOOOOOOOOOOOOOOXXXXXXXXXXXXXVVVVVVVV#
#XXXOXXXOOXXXXOXXOXXXXXXXXXXXXXVVVVVVVV#
#OXXXXOOOXXXOOXXXXXXXXXXXXXXXXXVVVVVVVV#
#XXXOXXOXXO#############################
#OOOOOOOOOO#############################
#OXXXXXXXXX##EXOOXXXXXOXXXXXXXXXXXOXXXX#
#XXOXXXXXXX##XXOXXOXXXXXXOXOXXXXXOOOXXO#
#XOOXXXXXXX##XOXXOXOXXXXXXXXXXXXXOOXXXX#
#OXOXXXXXXX##SXXOXXXXOOXXXXXXXXXXXOXXXX#
#OXXXXXXXOX##########################XX#
#OXXXXXXOXXXX_____X_____X_____X_____#XX#
#XXXXXOXXOOXO_____X_____X_____X_____#XX#
#XXOXXXOXXXOX_____X_____X_____X_____#XX#
#OOXOXXXXXXXX_____X_____X_____X_____#XX#
#XXOXXXXXXXOO____MX____MX____MX____MX__#
########################################